c:/perlprogs/mine/libs/
===================
(autogenerated - do not edit)
TABLE
File	Full path
---toc---.txt	c:/perlprogs/mine/libs/---toc---.txt
LogFile.pm	c:/perlprogs/mine/libs/LogFile.pm
SettingsDialog.pm	c:/perlprogs/mine/libs/SettingsDialog.pm
cashflow.pm	c:/perlprogs/mine/libs/cashflow.pm
common.pm	c:/perlprogs/mine/libs/common.pm
docx2txt.pm	c:/perlprogs/mine/libs/docx2txt.pm
dollars.pm	c:/perlprogs/mine/libs/dollars.pm
elasticsearch_bulk_indexer.pm	c:/perlprogs/mine/libs/elasticsearch_bulk_indexer.pm
elasticsearcher.pm	c:/perlprogs/mine/libs/elasticsearcher.pm
em_dialog.pm	c:/perlprogs/mine/libs/em_dialog.pm
ext.pm	c:/perlprogs/mine/libs/ext.pm
holidays.pm	c:/perlprogs/mine/libs/holidays.pm
intramine_config.pm	c:/perlprogs/mine/libs/intramine_config.pm
pod2thml_intramine.pm	c:/perlprogs/mine/libs/pod2thml_intramine.pm
reverse_filepaths.pm	c:/perlprogs/mine/libs/reverse_filepaths.pm
swarmserver.pm	c:/perlprogs/mine/libs/swarmserver.pm
tocmaker.pm	c:/perlprogs/mine/libs/tocmaker.pm
win_wide_filepaths.pm	c:/perlprogs/mine/libs/win_wide_filepaths.pm
